1111111111111111111
1000B00B00000000001
1000101001000000001
1011101011101110001
100E1010P1010000001
1011101110011010001
1000001110010111001
101010111000C000001
1000B00000000010001
1010100CB0000010001
1000000000111110001
1000000000000000001
1111111111111111111
