1111111111111111111
1000000000000000001
1000101001000B00001
1011101011101110001
100E1010P1010000001
1011100000011010001
1000001111010111001
101010111100C000001
1000001111000010001
1010100C00000010001
1000000000111110001
1000000000000000001
1111111111111111111
