1111111111111111111
1000000000000000001
1000101001000000001
1011101011101110001
100E1010P1010000001
1011101110011010001
1000001C10010111001
1010101110000000001
1000000000000010001
1010100000000010001
1000000000111110001
1000000000000000001
1111111111111111111
