1111111111111111111
1000000000000000001
1000101001000B000C1
1011101011101110001
100E1010P1010000001
1011100000011010001
1000001111010111001
101010111100C000001
1000001111010010001
1000000000000010001
1111111111111111111
