1111
0000
1111
1111
1111
2222
