111111111111111111111
1000P0000000000B000E1
111111111111111111111
