111111
1P00E1
101101
101101
10C001
100001
1000B1
111111
