111111111111111
101000000000001
101101001100001
100000001100001
101101000000001
101011100000001
100001000000001
111111111111111
