11111
10EP1
100C1
11011
11011
11011
1B001
1C0C1
11111
