11111
100P1
10001
11011
11011
11011
10001
1C0C1
11111
