11111
10P01
10001
11011
11011
11111
