11111111
1E0000B1
1P000001
11111111
